3 2 3 4 3 2 3 2 3 3
0 3 0 2 0 4 0 5 0 3
0 4 0 3 0 4 0 6 0 3
4 3 4 2 3 2 4 3 4 2
0 5 0 3 0 4 0 5 0 3
0 4 0 2 0 3 0 4 0 4
3 4 2 4 2 4 6 5 4 3
0 5 0 2 0 5 0 3 0 3
0 7 0 2 0 6 0 2 0 4
4 5 6 4 4 4 1 2 3 4
